




                                                                                                                               22
                                                                                                                           2111111111122211
                                                                                                                      221111111111111111111                                                                                                                                 1111112   1111111                                                                                      2                22
                                                                                   111122                      1111111111111111111111111111                           22    22                                 2                                              22           11111111   111111111111111   22                              22                        1111          11111           111111
                                                                               111111111111           1222111111111111111111111111111111111   1111                 11111111111111                          1111111                      22              111111111111111111111111111   111111111111111111111111                      111111111112221122221222211111111111111111111111111111111111111111
                                        111111                111111111    11111111111111111111   11111111111111111111111111111111111111111   11111112          11111111111111111111                  1111111111111                  1111111111111222111111111111111111111111111111   1111111111111111111111111112111111112222111111111111111111111111111111111111111111111111111111111111111111111111
   p                      22     1222111111111222212222111111111111111122221111111111111111111122211111111111111111111111111111111111111111   1111111111111111111111111111111111111111   22        111111111111111111          1111111111111111111111111111111111111111111111111111   1111111111111111111111111111111111111111111111111111111111111111111111111111111111111111111111111111111111111111
111111111111122212221111111111111111111111111111111111111111111111111111111111111111111111111111111111111111111111111111111111111111111111122211111111111111111111111111111111111111111111111   1111111111111111111111      11111111111111111111111111111111111111111111111111111112221111111111111111111111111111111111111111111111111111111111111111111111111111111111111111111111111111111111111111
111111111111111111111111111111111111111111111111111111111111111111111111111111111111111111111111111111111111111111111111111111111111111111111111111111111111111111111111111111111111111111111111111111111111111111111112211111111111111111111111111111111111111111111111111111111111111111111111111111111111111111111111111111111111111111111111111111111111111111111111111111111111111111111111111111