##########
#        #
# XXXX   #
# X OO   #
# XO  O  #
#   OOP  #
#               #
#        #
#        #
##########