#######
#  X O#
# P   #
# X O #
#######