#######
#      #
# P  X#
#O    #
######