##########
#        #
#  XXX X #
# X OO   #
# XO  O  #
#   OOP  #
#        #
#        #
#        #
##########