#
##
# #
#  #
#   #
#    #
#     #
#      #
#       #
#        #
#         #
#          #
#           #
#      X     #
#             #
#              #
#               #
#  P          O  #
#                 #
####################